000000000000093333333333333333333333333A0000000000
9222232222222B666666666666B666666666666B23A0000000
10000100000001000000000000100000000000010540000000
100001000000010000000000001000000922222B2B40000000
10000100000001000000000000100000010000010540000000
10000100000001000000000000100000010000010540000000
1000010922222B222322222222B222222B2222280540000000
10000101000001000100000000100000010000000540000000
10000101000001000100000000100000010000000540000000
72222B2B22222B222B22222222B333333B3333333B40000000
000001010000010001000000005666666B6666666B40000000
00000101000001009400000000100000010000000540000000
00922B2B22222B22BB33333333400000010000000540000000
00100101000001007666666666B22222340000000540000000
00100101000001000000000000100000540000000540000000
00100101000001000000000000100000540000000540000000
00100101000005222222222222B23222BB2222222BB2222A00
00100101000001000000000000101000540000000540000100
0010052B22222B222222222222B2B222BB2222222B40000100
00100101000001000000000000101000540000000540000100
00100101000001000000000000101000540000000540000100
00100101000001000933333333B3B333BB2222222640000100
00722B2B22222B222B66666666B6B666B40000000010000100
00000101000001000100000000101000540000000010000100
00000101000001000100000000101000540000000010000100
0000053B33333B333B33333333B3B333B40000000010000100
000005B666666B666B66666666B6B666BB22222222B2222400
00000540000001000100000000101000540000000010000100
00000540000001000100000000101000540000000940000100
0000054009333B333B333333A0101000540000000540000100
09222BB226666B666B666666B2B2B222BB22222226B2222400
01000540000001000100000010101000540000000010000100
01000540000001000100000010101000540000000010000100
01000540000001000100000010101000540000000010000100
01000540000001000100000010101000540000000010000100
01000540000001000100000010101000540000000010000100
01092BB222222B222B222222B2B2B222BB22222222B2222800
01010540000001000100000010101000540000000010000000
0107266222222B2A0100000010101000540000000010000000
01000000000001010100000010101000540000000010000000
0100000922222B2B2B333333B3B34000540000000010000000
010000010000010107B66666B6B66222BB2222222240000000
01000001000001010010000010100000540000000010000000
01000001000001010010000072622222B40000000010000000
01000001000001010010000000000000540000000010000000
01000001000001010010000000000000540000000010000000
0722222B2222262B33B3333333333333BB2222222280000000
00000001000000076666666666666666640000000000000000
00000001000000000000000000000000010000000000000000
00000007222222222222222222222222280000000000000000
