0000000000933333333333332A09222222222232223222222A
0009222222B66666666B666401010000000000100010000001
00010000001000000001000101010000000000100010000001
00010000001000000001000101010000000000100010000001
00073333334000000001000101010000000000100010000001
00005BBBBBB33333333B333B3B3B223222222262A010000001
0009B66666B66666666BB66B6B680010000000001010000001
00054000001000000005400101000010000000001010000001
0005400000100000092BB22B2B2222B222222A001010000001
00054000001000000105400101000010000001001010000001
0005409222B222232B2BB22B2B2222B2222228001010000001
00054010001000010105400101000010000000001010000001
00054010001000010105400101000010000000001010000001
00054010005333340105400101000010000000001010000001
000540100056666B2B2BB22B2B222240000000001010000001
00054010001000010105400101000010000000001010000001
00054010001000010105B22B2B2222B222222322B2B2222228
00054010001000010105400101000010000001001010000000
00054010001000010105400101000010000001001010000000
000540100010000101054001072222B2222228001010000000
0007B2B222B2223B3B3B400100000010000000001010000000
000010100010005B6BBBB22B222222B222222222B2B22A0000
000010100010005405BB400100000010000000001010010000
000010100010005405BB400100000010000000001010010000
000010100010005405BB400100000010000000001010010000
000010100010005405BB400100000010000000001010010000
9322B2B222B222BB3BBBB33B333333B333333222B280010000
540010100010005BBBBBBBBBBBBBBBB6666B40001000010000
540010100010007B6BBB6B6B66666640000540001000010000
540010100010000105B4010100000010000540001000010000
5400107222B2222B2BB4010100000010000540001000010000
540010000010000105B4010100000010000540001000010000
540010000010000105B4010100000010000540001000010000
540010000010000107B4010100000010000540001000010000
54001000001000010054010100000010000540001000010000
540010000010000722BB2B2800000010000540001000010000
54001000001000000054010000000010000540001000010000
7B22622222B3333333BB3B333A000010000540001000010000
010000000076666666BBBBBBBB3333B3333BB222B222280000
0100000000000000005BBBBBBBBBBBBBBBBB40001000000000
0722222222222222226B6B666B6666B66666B2228000000000
00000000000000000001010001000010000010000000000000
00000000000000000005262228000010000010000000000000
00000000000000000001000000000010000010000000000000
00000000000000000007222222222262222280000000000000
00000000000000000000000000000000000000000000000000
00000000000000000000000000000000000000000000000000
00000000000000000000000000000000000000000000000000
00000000000000000000000000000000000000000000000000
00000000000000000000000000000000000000000000000000
