000000000000000000000092322222222222222222A0000000
00000000000000000000001010000000000000000010000000
0000000000000009333333B3B33333333333333333B33A0000
000009222222223B666666B6BBBBBBBBBBBBBBB666B6640000
00000100000000540000001076666666666666400010010000
00000100000000540000001000000000000000100010010000
00000100000000540000001000000000000000100010010000
00000100000000540000001000000000000000100010010000
00922B22322222BB222222B222322222222222B222B2240000
00100100100000540000001000100000000000100010010000
00100100100000540000001000100000000000100010010000
001001001000005B322222B222B22322222222B223B22B32A0
001001001000005B4000001000100100000000100540054010
001001001000005B4000001000100100000000100540054010
001001001000005B4000001000100100000000100540054010
001001001000005B4000001000100100000000100540054010
001001001000005B4000001000100100000000100540058010
00109B33B33333BBB33333B333B33B33333333400540010010
00107B66B66666BBB66666B666B66B66666666400540010010
001001001000005B4000001000100100000000100540010010
001001001000005B4000001000100100000000100540010010
00100522BA00005B4000001000100100000000100540010010
001001005400005B4000001000100100000000100540010010
001001005400005B4000001000100100000000100540010010
09B224005400005B4000001000100100000000100540010010
054001005400005B4000001000100100000000100540010010
054001005400005B4000007222B22B23222222B22B40010010
054001005400005B4000000000100101000000100540010010
054001005400005B4000000000100101000000100540010010
054001005400005B4000000000100101000000100540010010
054001005400005B4000000000100101000000100540010010
05400522BB2222BBB222222222B22B2B222222B22BB22B2340
054001005400005B4000000000100101000000100540010540
05400100562222BBB222222222B22B2B222222B22BB2240540
054001001000005B4000000000100101000000100540010540
07B22B33B33333BBB333333333B33B3B333333B33B40010540
00100566B66666BBB666666666B66B6B666666B66B40010540
001001001000005B4000000000100101000000100540010540
00100100100000566222222222B22B28000000100540010540
00100100100000100000000000100100000000100540010540
00100722B22222622222222222B22B22222222622BB22B2B40
00100000100000000000000000100100000000000540010540
00100000100000000000000000100100000000000540010540
00100000100000000000000000100100000000000780010540
00100000100000000000000000100100000000000000010540
001000001000000000000000005A0100000000000000010540
00722222622222222222222222662B222222222222222B2680
00000000000000000000000000000100000000000000010000
00000000000000000000000000000100000000000000010000
00000000000000000000000000000722222222222222280000
