00000000000000000000000000000000000000000000000000
0000000922222222222222222222322222222222A000000000
00000001000000000000000000001000000000001000000000
00000001000000000000000000001000000000001000000000
00000001000000000000000000001000000000001000000000
0000000100922222222222222222B22222222222B2222A0000
0932222BA01000000000000000001000000000001000010000
05400005401000000000000000001000000000001000010000
0540000540100000000000000000100000000922B222340000
0540000540533333322222222223B322A00001001000540000
0562222BB2B66666400000000005B400100001001000540000
0100000540100000100000000005B400100001001000540000
0100000540100000100000000005B400100001001000540000
0100000540100000100000000005B400100001001000540000
010000054010000010922222222BBB2362222B22B222640000
0100000540100000101000000005B401000001001000010000
0100000540109333B3B33333333BBB3B33333B33B3333B333A
9B22222BB3B3BBBBBBBBBBBBBBBBBBBBBBBBBBBBB6666B6664
54000005B6B6B666B6B66666666BBB6B66666B664000010001
5400000540101000101000000005B401000001001000010001
5400000540101000101000000005B401000001001000010001
54000005401010001010000000056B2B22222B22B2222B2228
5B22222BB3B3B333B2B22A0000010101000001001000010000
54000005B6B6B6664010010000010101000005A01000010000
54000005401010001010010000010101000005401000010000
5400000540101000101001000001010533333B401000010000
54000005401010001010010000072B266666BBB2B222240000
5400000540101000101001000000010000005B401000010000
5400000540101000101001000000010000005B401000010000
5400000540101000101001000000010000005B401000010000
5632222BB2B2B222B3B33B3333333B222222BBB2B222280000
101000054010100076B66B666666640000005B401000000000
1010000540101000001001000000010000005B401000000000
101000054072B22222B22B2222222B222222BBB24000000000
1010000540001000001001000000010000005B401000000000
1010000540001000001001000000010000005B401000000000
10100007B222622222B22B2322222B222222BB401000000000
1010000010000000001001010000010000005B401000000000
101000005333333333BA01010000010000005B401000000000
10722222B666666666B62B2B222226222222B6624000000000
10000000100000000010010100000000000010001000000000
10000000100000000010010100000000000010001000000000
10000000100000000010010100000000000010001000000000
10000000100000000010010100000000000010001000000000
10000000100000000010010100000000000010001000000000
10000000100000000010010100000000000010001000000000
10000000100000000010010100000000000010001000000000
72222222B333333333B33B3B22222222222262228000000000
00000000766666666666666800000000000000000000000000
00000000000000000000000000000000000000000000000000
