00000000000000000000000000000000000000000000000000
0000000000000933333333333A000000000000000000000000
0000000000009B66666666666B22222222222222223222222A
00000000000054000000000001000000000000000010000001
00000000000054000000000001000000000000000010000001
000000922322BB22222222222B2222323222A0000010000001
00000010010054000000000001000010100010000053222228
00000010010054000000000001000010100010000054000000
00000010010054000000000001000010100010000054000000
00000010010054000000000001000010100010000054000000
00000010010054000000000001000010100010000054000000
00000010010054000000000001000010100010000054000000
0000001005A054000000000001000010100010000054000000
0000001005405B222222222228000010100010000054000000
00000010054054000000000000000010100010000054000000
00000010054054000000000000000010100010000054000000
00000010054054000000000000000010100010000054000000
000000100540540093333A0000000010100010000054000000
922222B22BB2BB2266666BA000000010100010000054000000
10000010054054000000054000000010100010000054000000
10000010054054000000054000000010100010000054000000
100000100540540009222BB2222222B2B2A010000054000000
10000010054054000100054000000010101010000054000000
100092B22BB2BB222B333BB3333333B2B2B240000054000000
100010100540540005666B6666B66640101010000054000000
10001010054054000100010000100010101010000054000000
10001010054054000100010000100010101010000054000000
100010100562BB333B322B2222B222B2B2B240000054000000
1000101001005BBBBB40010000100010101010000054000000
1000101001005B666B80010000100010101010000054000000
10001010010054000100010000100010101010000054000000
1092B2B22B23BB222B222B3333B222B2B2B2B22222BB2222A0
101010100105B4000100056666800010101010000054000010
101010100105B4000100010000000010534010000054000010
101072622B2B640001000522222222B2B662B22222BB222240
10100000010101000100010000000010100010000054000010
10100000010101000100010000000010100010000054000010
10100000010101000100010000000010100010000054000010
72B222222B2B2B222B333B22222222B2B222B22222B8000010
00100000010101000766680000000010100010000010000010
00100000010101000000000000000010100010000010000010
00100000010101000000000000000052B22280000010000010
00100000010101000000000000000010100000000010000010
00100000010101000000000000000010100000000010000010
00100000010101000000000000000010100000000010000010
00100000010101000000000000000010100000000010000010
007222222B262B2222222222222222B2800000000010000010
00000000010001000000000000000010000000000010000010
00000000010001000000000000000010000000000072222280
00000000072226222222222222222280000000000000000000
