00000000000000000000000000000000000000000000000000
00000000000000000000009222A00000000000000000000000
00000000000000000000001000100000000000000000000000
00000000000000000000001000100000000000000000000000
00000000000000000000001000100000000000000000000000
00000000000000000000001000100000000000000000000000
0000000093333333333333B333B3333A000000000000000000
92222222B666666BB6B666B666B6666B2222222222222A0000
10000000100000054010001000100001000000000000010000
10000000100000054010001000100001000000000000010000
72222222B222322BB2B222B222B2322B222322A00000010000
00000000100010054010001000101001000100100000010000
00000000100010054010001000524001000100100000010000
0000000010001005B3B3334000101001000100100000010000
000000001000533BBBBBBBB333B3B22B222400100000010000
00092222B222666BBBB6666666B64001000100100000010000
0001000010000005BB40000000101001000100100000010000
0001000010000005BB40000000101001000100100000010000
0001000010000005BB40000000101001000100100000010000
0001000010000005BB40093333B3B33B222B22B22222240000
0001000010000005BBB22B6666B666B4000100100000010000
0001000052A00005BB40010000100054000100100000010000
0001000010100005BB40010000100054000100100000010000
0001000010100005BB40010000100054000100100000010000
000100001053333BBBB33B3333B333BB333B33B3333A010000
092B2222B2B6666BBBB66B6666B66BBB666B66B6666B280000
0101000010100005BB400100001005B4000100100001000000
0101000010100005BB400100001005B4000100100001000000
05262222B2B2222BBBB22B2222B22BBB222B22800001000000
0100000010100005BB400100001005B4000100000001000000
0100000010100005BB400533334005B4000100000001000000
0100000052B2222BBBB2266666B22BBB232400000001000000
0100000010100005BB400000001005B4010100000001000000
0100000010100005BB400000001005B4010100000001000000
0100000010100005BB400000001005B4010100000001000000
0100000010100005BB400000001005B4010100000001000000
01000000101000056BB33333A01005B4010100000001000000
010000001010000105BBBBBBB3B33BBB2B2B2222222B2A0000
0100000053B3333B3BB66666B6B66B64010100000001010000
0722222266BBBBBBBB40000010100101010100000001010000
000000000056666B6BB22222B2B22B2B280100000001010000
00000000001000010540000010100101000100000001010000
00000000001000010540000010100101000100000001010000
00000000001000010540000010100107222800000001010000
00000000001000010540000010100100000000000001010000
00000000001000010540000010100100000000000007280000
00000000001000010540000010100100000000000000000000
00000000001000010540000010100100000000000000000000
000000000072222B3BB33333B3400100000000000000000000
00000000000000076666666666622800000000000000000000
