92222222222222333333333333333A00000000000000000000
1000000000000056B666666B66666B23222222A00000000000
100000000000001010000001000001010000001000000922A0
10092222222222B3B333333400000101000000100000010010
1001000000000056B666666622222B2B222A00100000010010
1005322222A000101000000000000101000100100000010010
10054000001000101000000000000101000100100000010010
10054000001000101000000000000101000100100000010010
10054000001000101000009333333B3B332B22800000010010
1005400000100053B33333BBBBBBBBBBB40100000000010010
722BB22222B222B6B666666666666B6B6B2400000000010010
00054000001000101000000000000101010100000000010010
00054000001000101000000000000101010100000000010010
00054000001000101000000000000101010100000000010010
00054000001000101000000000000101010100000000010010
9226B22222B322B2B222222222222B3B3B2B22222222340010
1000100000540010100000000000056B6801000000005B2240
10001000005400101000000000000101000100000000540010
10001000005400101000000000000101000100000000540010
10001000005400101000000000000101000100000000540010
10001000005400101000000000000101000100000000540010
1092B22333BB33B3B333333333333B3B333B33333333B40010
1010100766BB66B6B6666B6666B66B6B666B66666666BB2240
10101000005400101000010000100101000100000000540010
10101000005400101000010000100101000100000000540010
10101000007B22B2B2222B2222B22B2B222B22222222BB2240
10101000000100101000010000100101000100000000540010
10101000000100101000010000100101000100000000540010
10101000000100101000010000100101000100000000540010
10101000000100101000010000100101000100000000540010
72B2B333333B33B3B3333B3333B33B3B333400000000540010
00105666666B66B666666B6666B66B6B666622222222B40010
00101000000100100000010000100101000000000000540010
001010000001001000009B3333B33B3B333333333333B40010
00101000000522B22222BB6666B66B6B666666666666B80010
00101000000100100000540000100101000000000000100010
00101000000100100000540000100101000000000000100010
00107222222B22B22222BB2222B22801000000000000100010
00100000000100100000540000100001000000000000100010
00100000000100100000540000100001000000000000100010
00100000000722B22222BB3333B2222B222222222222400010
001000000000001000007B6666800001000000000000100010
00100000000000100000010000000001000000000000100010
00100000000000100000010000000001000000000000100010
00100000000000100000010000000001000000000000100010
0010000000000010000007222222222B222222222222B22280
00100000000000100000000000000001000000000000100000
00100000000000100000000000000001000000000000100000
00100000000000100000000092222226222222222222800000
00722222222222622222222280000000000000000000000000
