0000000000000000933333333333333333333333322222A000
00000000000000005BBBBBBBBBBBBBBBBBBBBBBB4000001000
0000009222222222BBB66666B6666B666B6B66B6B222A01000
00000010000000005B40000010000100010100101000101000
00000010000000005B40000010000100010100101000101000
092222B222232222BBB22222B2232B222B2400101000101000
01000010000100005B40000010010100010100101000101000
01000010000100005B40000010010100010100101000101000
01000010000100005B40000010010100010100101000101000
01000010000100005B40000010010100010100101000101000
0100001000010009BBB22222B23B3B33340100101000101000
0100001000010005BB400000105B6B666B2B22B2B222B34000
0100001000010005BB400000105401000101001010005B4000
0100001000010005BB400000105401000101001010005B4000
0100005A00010005B6B22222B2B401000101001010005B4000
010000540001000540100000105401000101001010005B4000
010000540001000540100000105401000101001010005B4000
010000540001000540100000105401000101005280005B4000
010000540001000540100000105401000101001000005B4000
010000540001000540100000105B34000101001000005B4000
053222BB222B222662B22222B2B66B222B2B22B22222BB4000
054000540001000000100000101001000101001000005B4000
054000540001000000100000101001000101001000005B4000
054000540001000000100000101001000101001000005B4000
054000540001000000100000101001000101001000005B4000
054000540001000000109333B2B224000101001000005B4000
05400054000722222262B666401001000101001000005B4000
054000540000000000001000101001000101001000005B4000
054000540000000000001000101001000101001000005B4000
05B222BB222222222222B222B2B22B222B2B22B22222BB8000
05400054000000000000100010100100010100100000540000
0540005B222222222222B222B2B22B333B3B33B33222B40000
054000540000000000001000101005666B6B66B68000540000
05400054000000000000100010100100010100100000540000
05400054000000000000100010100100010100100000540000
05400054000000922222B22280100100010100100000540000
05400054000000100000100000100100010100100000540000
05400054000000100000100000100100010100100000540000
0540007B222222B22222B22222B22B222B2B22B22222B40000
05400001000000100000100000100100010100100000540000
05400005333333B33333B33333B33B333B3B33B33333B40000
07B2222B666666B66666B66666BBBB666B6B66B66666B80000
00100001000000100000100000766800010100100000100000
00100001000000100000100000000000010100100000100000
00100007222222B22222B333333333333B2B22800000100000
00100000000000100000766666666666680100000000100000
00100000000000100000000000000000000100000000100000
09B33333333333B22222222222222222222622222222800000
07666666666666800000000000000000000000000000000000
00000000000000000000000000000000000000000000000000
