00000000000000000000000000000000000000000000000000
000009222222232222222222322222222222222222222222A0
00000100000001000000000010000000000000000000000010
000007A0000001000000000010000000000000000000000010
00000010000001000000000010000000000000000000000010
922222B222222B222322222262222222A00000000000000010
10000010000001000100000000000000100000000000000010
10000010000001000100000000000000100000000000000010
10000010000001000100000000000000100000000000000010
1000001000092B222B22223333333A00100000000000000010
10000010000101000100007666666B22B222222222A0000010
10000010000101000100000000000100100000000010000010
10000010000101000100000000000100100000000010000010
10000010000101009B22222222A00100100000000010000010
10000010000101005400000000100100100000000010000010
10000010000101005400000000100100100000000010000010
10000010000101005400009333B33B33B3322222A010000010
10000010000101005B2222B666B66B66B64000001010000010
10000010000101005400001000100100101000094010000010
10000010000101005400001000100100101000054010000010
722222B2222B3B22BB2233B222B22400101000054010000010
000000100005B40054005B4000100100101000054010000010
000000100005B40054005B40001001001052222BB2B22222BA
000000100005BB22BB22BBB222622B23401000054010000054
000000100005B40054005B4000000105401000054010000054
000000100005BB33BB33BBB333333B2BB2B2222B4010000054
000092B2222BBB66BB66BBB666666405401000054010000054
000010100005B40054005B4000000105401000054010000054
000010100005B40054005B4000000105401000054010000054
000010100005B40054005B4092222B2B6262222BB2B22222B4
000010100005B40054005B4010000101000000054010000054
000010100005B40054005B4010000101000000054010000054
000010100005B40054005B62B2222801000000054010000054
000010100005B4005400540010000001000000054010000054
000010100005B4005400540010000001000000054010000054
000010100005B4005400540010000001000000054010000054
000010100005B40054005400100000010000092B4010000054
000010100005B4005400540010000001000001054010000054
000010100005B400540054001000933B33333B3BB340000054
000010100005B400540056226222B66B66666B6BB662222264
000010100005B4005400100000001001000001054000000001
00001072222BB4005400100000001001000001054000000001
000010000005B4005400100000001001000001054000000001
000010000005B4005400100000001001000001054000000001
000010000005B4005400100000001001000001054000000001
000010000005B4005400100000001001000001054000000001
00005333333BBB33BB33B3333333B33B33A001054000000001
00007666666BBBBBBBBBBBBBBBBBBBBBBBB33B3BB333333334
000000000007BBBBBBBBBBBBBBBBBBBBBBBBBB666666666668
00000000000076666666666666666666666668000000000000
