00000000000000000000000000000000000000000000000000
0000000000000093333333333333333333333A000000000000
000000000000005BBBBBBBBBBBBBBBBBBBBBBBA00000000000
00000009222222B6666666666666666666666B400000000000
00000001000000100000000000000000000005400000000000
00000001000000100000000000000000000005B22222223A00
00000001000000100000000000000000000005400000005400
00000001000000100000000000000000000005400000005400
00000001000000100000000000000000000005400000005400
0000000100000010009222222223222222222BB2222223B400
0000000100000010001000000001000000000540000005B400
0000000100000010001000000001000000000540000005B400
0000000100000010001000000001000000000540000005B400
0000000100000010001000000001000000000540000005B400
0000009B333333B333B33333333B333333333BB3322A05B400
000009BB666666B666B66666666B666666666BBB400105B400
000005B4000000100010000000010000000005BB400105B400
000005BB222223B322B22222222B33333A0005BB400105B400
000005B4000005B4001000000007B6666B222BBBB23B26B400
000005B4000005B40010000000001000010005BB4054005400
000005B4000005B40010000000001000010005BB4054005400
000005B4000005B40010000000001000010005BB4054005400
000005B4000005B40010000000001000010005BB4054005400
000005B4000005B400100000000053333B333BBB4054005400
000005B4000005B4005222222222B6666B666BBB62BB22BBA0
000005B4000005B40010000000001000010005B40054005B40
000005BB33333BBB33B333333333B3333B333BB40054005B40
09222BBB666666BB6666B666666666666B666B6B22BB22BB80
010005B4000000540000100000000000010001010054005400
010005B4000000540000100000000000010001010054005400
010005B4000000540000100000000000010001010074005400
010005B4000000540000100000000000010001010001005400
010005B4000092BB2222B222222222222B22262B222B22B400
010005B4000010540000100000000000010000010001005400
010005B62222B2BB22226222222222222B22222B222B226400
01000540000010540000000000000000010000010001000100
010005400000105400000000009222222B22222B2224000100
01000540000010540000000000100000010000010001000100
01000540000010540000000000100000010000010001000100
01000540000010540000000000100000010000010001000100
05322B40000010540000000000100000010000010001000100
05400540000010540000000000100000010000010001000100
054005622222B3BB3333333333B333333B33333B2226222BA0
05400100000056B66666666666B666666B6666680000000540
05400100000010100000000000100000010000000000000540
05622B222222B26222222222226222222B2222222222222B80
01000100000010000000000000000000010000000000000100
010007222222B22222222222222222222B2222222222222800
01000000000010000000000000000000010000000000000000
07222222222262222222222222222222280000000000000000
