00000000000000000000000000000000000000000000000000
0000000009222222222222222222222222222222222222A000
00000000010000000000000000000000000000000000001000
000000092B22A00000000000000000093333333333A0001000
0000000101001092222222222222222B6666666666B222B2A0
00000001010010100000000000000001000000000010001010
0092233B3B33B3B3333333333333333B33A000000010001010
0010056B6B66B6B666666BBBBBBBBBBB66B22A000010001010
00100101010010100000076B666666B4001001000010001010
00100101010010100000000100000054001001000010001010
00100101010010100000000100000054001001000010001010
00100101010010100000000100000054001001000010001010
00100101010010100009222B222222BB22B22B2222B222B240
00100101010010100001000100000054001001000010001010
00100101010010100005322B222222BB22B22B2222B222B240
00100101010010100005400100000054001001000010001010
001001010100101000054007222222BB224001000010001010
00100101010053400005400000000054001001000010001010
0010010101005B400005400000000054001001000010001010
0010010101005B40000540000000005B33B33B3332B2234010
00533B3B3B33BBB22226B222222222BB66B66B664010054010
09666B6B6B66BB400000100000000054001001001010054010
0100010101005B400000100000000054001001001010054010
0100010101005B400000100000000054001001001010054010
010001072B22BBB22222B222222222BB22B22B2262B22BB240
0100010001005B400000100000000054001001000010054010
0100010001005B400000100000000054001001000010054010
0100010001005B400000100000000054001001000010054010
0100010001005B4000001009222222BB22B22B2222B2264010
0722280001005B400000100100000054001001000010001010
0000000001005B400009B33B333333B4001001000010001010
00000000010056B2222BB666666666BB22B22B222240001010
00000000010010100005400000000054001001000010001010
000000000722B2B2222B6222222222BB22B22B2222B222B240
00000000000010100001000000000054001001000010001010
0000000000001010000100000000005B22B228000010001010
00000000000010100001000000000054001000000010001010
00000000000010100001000000000054001000000010001010
00000000000010100001000000000054001000000010001010
00000000000010100001000000000054001000000010001010
00000000000072B3333B3333333333BB33B3333333B2228010
0000000000000076666B66666666666B66B666666640000010
00000000000000000001000000000001001000000010000010
00922222222222222228000000000001001000000010000010
00100000000000000000000000000001001000000010000010
00100000000000000000000000000001001000000010000010
0010000000000000000000000000000533B322222262222280
00722222222222222222222222222226666800000000000000
00000000000000000000000000000000000000000000000000
00000000000000000000000000000000000000000000000000
