00000000000000000000000000000000000000000922A00000
00000000000000000000000000000000000000000100100000
00922222222232222232322222222222222222223B23400000
00100000000010000010100000000000000000005405400000
00100000000010000010100000000000000000005405400000
0010000000001000001010092322222222222222BB2BB2A000
00100000000010000010100101000000000000005405401000
00100000000010000010100101000000000000005405401000
005322222222B22222B2B22B2B333333333A00005405401000
00540000000010000010100105BBBBBBBBBB3333BB3BB24000
005B22222222B22222B2B22B2BB66666666B6666BB6B401000
00540000000010000010100105400000000100005405401000
00540000000010000010100105400000000100005405401000
00540000000010000010100105400000000100005405401000
00540000000010000010100105400000000100005405401000
00540000000010000010100105400000000100005405401000
0054000000001000001072262BB22222222B2232B805401000
005B2A00000010000010000005400000000100101007401000
00540100000010000010000005400000000100101000101000
0054010000001000007222222BB22222222B22B2B222B24000
00540100000010000000000005400000000100101000101000
00540100000010000000000005400000000100101000101000
00540100000010000000000005400000000109B2B222B2B22A
00540100000010000000000007400000000105401000101001
00540100000010000000000000100000000105401009401001
0054010000001000000000000010000000053BB2B22BB2B224
005401000000100000000000001000000005BB401005401001
005401000000100000000000001000000005BB401005401001
005626222222B2223333333333B23333333BBBB3B33BB28001
00100000000010005666666666805666666BBBB6B666400001
001000000000100010000000000010000005BB401000100001
001000000000100010000000000010000005BB401000100001
001000000000100010000000000010000005BB401000100001
001000000000100010000000000010000005BB401000100001
005222222222B222B22222222222B222222BBBB24000100001
001000000000100010000000000010000005BB401000100001
0010000000005222B22222222222B222222BBBB2B222B22228
001000000000100010000000000010000005BB401000100000
0010000000001000522222222222B22222266B401000100000
00100000000010001000000000001000000005401000100000
001000000000100010000000000010000000054010007A0000
00100000000052228000000000001000000005401000010000
00100000000010000000000000001000000005401000010000
00100000000010000000000000001000000005401000010000
0010000000001000000000000000100000000762B22226222A
09B333333333B3332222222222228000000000001000000001
05BBBBBBBBBBBBB40000000000000000000000001000000001
076666666666B666222222222222222222222222B222222228
00000000000010000000000000000000000000001000000000
00000000000072222222222222222222222222228000000000
