00000000000000000000000000000000000000000000000000
00000000000000000000000000000000000000000000000000
00000000000000000000000000000000000000000000000000
0000000000000000000000000009333333333333333333332A
0000000000000000000000000005BBBBBBBBBBBBBBBBBBB401
000000000009222222222222222B66B66666B666666666BB24
00000000000100000000000000010010000010000000005401
000000000001000000000000000109B22222B2222222226401
00000000000100000000000000010540000010000000000101
00000000000100000000000000010540000010000000000101
000000000001000000092222222B2BB22222B2222222222B24
00000000000100000001000000010540000010000000000101
00092222222B2222222B2222222B2BBA000010000000000101
000100000001000000010000000105B4000010000000000101
000100000001000000010000000105B4000010000000000101
000100000001000000010000000105BB3222B2222222223401
000100000001000000010000000105BB400010000000005401
00053322222B2233222B2222222B2BBBB222B222232222BB28
0005B4000001005400010000000105BB400010000100005400
0005B4000001005400010000000105BB400010000100005400
0005B400000722BB222B2222222B2BBBB222B3222B2222B800
0005B4000000005400010000000105BB400074000100001000
0005B400000000540001000000052BBB400001000100001000
0005B4000000005400010000000105BB400001000100001000
0005B4000000005400010000000105BB400001000100001000
0005B4000000005400010000000105BB400001000100001000
0005B4000000005400010000000105BB400001000100001000
0005B400000009BB222B2232222B2BB6B2222BA00100001000
0005B400000005B40001001000010540100005400100001000
0005B400000005B40001001000010762B2222B800100001000
0005B400000005B40001001000010000100001000100001000
0005B400000005B40001001000010000100001000100001000
0005B400000005B40001001000010000100001000100001000
0005B400000005B40001001000010000100001000100001000
0005BB2222222BBB222B22B2222B2222B2222B222B22224000
0005B400000005B40001001000010000100001000100001000
0005B400000005B40001001000010000100001000100001000
0005B400000005B40001001000010000100001000100001000
0005B400000007B40001001000010000100001000100001000
0005B4000000005B333B33B3333B3333B33334000100001000
00056B222222226B666B66B6666B6666666666222B22228000
00010100000000010001001000010000000000000100000000
00052800000000010001001000010000000000000100000000
00010000000000010001001000010000000000000100000000
0001000000000007222622B222280000000000000100000000
00010000000000000000001000000000000000000100000000
00010000000000000000001000000000000000000100000000
00010000000000000000001000000000000000000100000000
00010000000000000000001000000000000000000100000000
00072222222222222222226222222222222222222800000000
